0,0,0,0,0,0,0,0,0,0,0,0,0,0,0,0,0,0,0,0,0,0,0,0,0,0,0,0,0,0,0,0
0,0,0,0,0,0,0,0,0,0,0,0,0,0,0,0,0,0,0,0,0,0,0,0,0,0,0,0,0,0,0,0
0,0,0,0,0,0,0,0,0,0,0,0,0,0,0,0,0,0,0,0,0,0,0,0,0,0,0,0,0,0,0,0
0,0,0,0,0,0,0,41,42,43,0,0,0,0,0,0,41,42,43,0,0,0,0,0,41,42,43,0,0,0,0,0
0,0,0,0,0,0,0,57,0,0,0,0,0,0,0,0,57,0,0,0,0,0,0,0,57,0,0,0,0,0,0,0
0,0,0,0,0,0,0,57,0,0,0,0,0,0,0,0,57,0,0,0,0,0,0,0,57,0,0,0,0,0,0,0
0,0,0,0,0,0,0,57,0,0,0,0,0,0,0,0,57,0,0,0,0,0,0,0,57,0,0,0,0,0,0,0
0,0,0,0,0,0,0,57,0,0,0,0,0,0,0,0,57,0,0,0,0,0,0,0,57,0,0,0,0,0,0,0
0,0,0,0,0,0,0,57,0,0,0,0,0,0,0,0,57,0,0,0,0,0,0,0,57,0,0,0,0,0,0,0
0,0,0,0,0,0,0,73,0,0,0,0,0,0,0,0,73,0,0,0,0,0,0,0,73,0,0,0,0,0,0,0
0,0,0,0,0,0,0,13,14,15,0,0,0,0,0,0,89,0,0,0,0,0,0,3,6,0,0,0,0,0,0,0
10,10,10,10,10,10,10,29,30,31,15,10,10,10,10,11,10,10,10,10,11,10,10,19,22,10,10,10,10,10,10,10
36,23,36,23,36,23,36,45,46,47,2,23,36,23,36,24,17,4,4,18,8,23,36,35,38,23,36,23,36,23,36,23
4,4,4,4,4,4,4,4,4,4,4,4,4,4,4,18,33,20,20,34,17,4,4,35,38,4,4,4,4,4,4,4
20,20,20,20,20,20,20,20,20,20,20,20,20,20,20,34,37,36,36,37,33,20,20,36,36,20,20,20,20,20,20,20
36,36,36,36,36,36,36,36,36,36,36,36,36,36,36,37,53,36,36,53,37,36,36,36,36,36,36,36,36,36,36,36
36,36,36,36,36,36,36,36,36,36,36,36,36,36,36,53,37,36,36,37,53,36,36,36,36,36,36,36,36,36,36,36
36,36,36,36,36,36,36,36,36,36,36,36,36,36,36,37,53,36,36,53,37,36,36,36,36,36,36,36,36,36,36,36
